.acr "!unitlist" %user% typed `!unitlist`. This contains a picture of all units and common abbreviations.


__**Common Abbreviations (Updated 16/05/2018)**__
*One Star*
```
EA - Elf Archer
INF - Infantry
OF - Orc Fighter
SU - Skeleton Unit
```
*Two Star*
```
EW - Elf Warrior
Frost - Frost Mage
HI - Heavy Infantry
OH - Orc Hunter
PA - Poison Archer
Lock - Warlock
Ghost - Ghost
FB - Fire Bird
```
*Three Star*
```
HK - Hammer Knight
HEA - High Elf Archer
GE - Green Eagle
GHU - Great Hammer Unit
Musk - Musketeer
OHU - Orc Hammer Unit
OW - Orc Wing
SW - Skeleton Warrior
```
*Four Star*
```
BMW - Black Magic Wizard
CK - Cavalry Knight
OAU - Orc Ax Unit
WM - Wind Mage
```
*Five Star*
```
AL - Aladdin
Alch - Alchemist
AM - Abyss Mage
BD, Drummer - Battle Drummer
BF - Big Foot
BM - Blade Master
BU - Bomb Unit
Cleric - Cleric
Crow - Crow Knight
DA - Dark Archer
DaD - Dark Admiral
DE - Dark Elf
DK - Death Knight
Druid - Druid
DS - Dark Spirit
Elem - Elementalist
Ent - Ent
Fairy - Fairy
FD - Frost Demon
FG - Forest Guardian
FM - Fire Mage
FS - Fire Spirit
Goku - Hoyden Goku
Golem - Golem
GR - Griffin Rider
Gunner - Gunner
HB - Hot-Blooded Xuanzang
HG, Hippo - Hippogriff
HoD - Hands of Death
INC - Incubus
IS - Ice Spirit
IW - Ice Wizard
Lich - Lich
Med, Dusa, MoM - Medusa
Naga - Naga
NoD - Dark Ninja
Pilot - Pilot
Priest - Priest
Rangda - Rangda
Raptor, RR - Raptor Rider
Sage - Elf Sage
SD - Sword Dancer
Siren - Siren
Sorc - Sorcerer
SP - Steam Punk
Succ - Succubus
Sylph - Sylphid
Tress - Musketress
UK - Unicorn Knight
Valk - Valkyrie
Wiva - Windwalker
WK - Winged Knight
WR - Wolf Rider
WW - Wolf Warrior
Wyvern - Wyvern Rider
```
For localised unit names, consult <http://bit.ly/eftotmegasheet> abbriviation list
